11111111111111111111111111111111
11............................11
1.....U........M...............1
1..............................1
1..........................U...1
1.......1111111111111111.......1
1...U...1..............1.......1
1.......1...C..........1.......1
1.......1.........U....1.......1
1.......1..............1....M..1
1.......1......................1
1.......1......11......C.......1
1....U.........11......1..m....1
1..................U...1.......1
1.....L.1..............1.......1
1.....L.1.....C........1.......1
1.....L.1..............1.......1
1.....L.1..............1...M...1
1.....L.1111111111111111.......1
1...M.L........................1
1.....L......M............U....1
1.....L.U.......U.UUUU.........1
11....L......................P11
11111111111111111111111111111111